111111111
100C00001
100P00E01
111111111
