111111111
1E0C00001
100P00E01
111111111
