1111111111111
100000C0C0001
1100010001001
100011EE01001
1111111111111
