1111111111111
100000C0C0001
1000010001001
1P0011EE01001
1111111111111
