111111111
100C00001
100000E01
111111111
