1111111111111
1001000000001
1000011111001
100011ECP0001
1111111111111
